_me	plural (PL)	Grammar
ka	question (QM) (if used alone, can be translated as "what?")	Grammar
-le	verbalizer (VBLZ)	Grammar
-te	nominalizer (NMLZ)	Grammar
i	exclamatory, intensifier (EXCLAM, INTS)	Grammar
o-	genitive (GEN)	Grammar
-ya	adjectizer (ADJZ)	Grammar
g(e)-	negative (NEG)	Grammar
bo	lative (go towards) (LAT)	Grammar
kole/ndwa	simultaneous comitative (COM.SIM)	Grammar
ámdwa	sequential comitative (COM.SEQ)	Grammar
-to	Instrumental (INSTR)	Grammar
-(a)lala	diminutive (DIM)	Grammar
_pa	ablative (motion away) (ABL)	Grammar
-(o)lili	augmentive (AUG)	Grammar
í	vocative (VOC)	Grammar
ma	dative (DAT) (directed at/for)	Grammar
mbo	causative (CAUS)	Grammar
mana'a	human far past (H.FPST)	Tenses
mana	human near past (H.NPST)	Tenses
na	human near future (H.NFUT)	Tenses
na'a	human far future (H.FFUT)	Tenses
u'u	human gnomic (H.GNO)	Tenses
payepë	human hesternial (H.HEST)	Tenses
boyepë	human hodiernal (H.HOD)	Tenses
mangga'a	cannibal far past (CN.FPST)	Tenses
mangga	cannibal present (CN.PRS)	Tenses
lüngga	cannibal near past (CN.NPST)	Tenses
nangga	cannibal near future (CN.NFUT)	Tenses
nangga'a	cannibal far future (CN.FFUT)	Tenses
u'unga	cannibal gnomic (CN.GNO)	Tenses
payepënga	cannibal hesternial (CN.HEST)	Tenses
boyepënga	cannibal hodiernal (CN.HOD)	Tenses
ma'u'u	zoic far past (ZO.FPST)	Tenses
ma'u	zoic near past (ZO.NPST)	Tenses
lü'ü	zoic present (ZO.PRS)	Tenses
na'u	zoic near future (ZO.NFUT)	Tenses
na'u'u	zoic far future (ZO.FFUT)	Tenses
lu'u'u	zoic gnomic (ZO.GNO)	Tenses
'üpayepë	zoic hesternial (ZO.HEST)	Tenses
'üboyepë	zoic hodiernal (ZO.HOD)	Tenses
-'an	marks AGENTS action as being forced or out of their control (VOL)	Grammar
_gya	imperfective (IPFV)	Grammar
(noun) wa	locative (LOC)	Grammar
wa (noun)	copula (COP)	Grammar
kene_	inessive	Grammar